
R 111000000000000 1170000000000000000000000

C 0,110,130

SO pics/bricks.xpm

EA pics/Brown10_1.xpm
NO pics/greystone.xpm


WE pics/Orange1.xpm
S  pics/barrel.xpm
F 40,80,40

1111111111111111111111111111111111111111111111111
1000000000000000000000000000000000000000000000001
1000111110000000000000000000000000000000222200001
1000000000000000000000000000000000000000000000001
10000000000000000W0000000000000000000000000000001
1000000001111111111111111111111111111111111110001
100011111                                    1001
1000111111111111111111111111111111111111111111001
1000200000000000000000011111111111111100000000001
1000200000000000000000000111111111111100000000001
1000000000000000000000000011111111111100000020001
1000000000000000000000000001111111111100000000001
1101010100000000000000000000000000000011111101111
1000000000000000000000000000000000000011111101111
1002000100000000000000000000000000000000000001111
1000000000000000000000000000000000000011111111111
1111111111111111111111111111111111111111111111111
