R   750 500


NO pics/greystone.xpm
SO pics/bricks.xpm
WE pics/Orange1.xpm
EA pics/Brown10_1.xpm

S pics/barrel.xpm
F 40,80,40
C 0,100,140

11111111111111111111111111111111111111111111111111111
11111111000000000000000000000000000000000000000000021
11111111000000000000000000000000000000021111111111101
12000000000000001000011111111111111111111111111111011
1100000000N000000000002000000000000000000000000000001
12000000000000001000001111111111111111111111111111111
11111111000000000000000000000000000000001
1111111100000000000000000000000000000002111111
1111111100111111111111111111111111111111110011
11111111001                              10011
11111111001                              10011
1111111100111111111111111111111111111111110011
1111111100000000000000000000000000000000000021
1111111100000000000000000000000000000000000021
1111111111111111111111111111111111111111111111
