R   800 550



NO pics/greystone.xpm
SO pics/bricks.xpm
WE pics/Orange1.xpm
EA pics/Brown10_1.xpm

S pics/barrel.xpm
F 25,75,25 
C 0,40,75

11111111111111111111111111111111111111111
11111111111111111111111111111111111111111
10000000000001000000000000000000000000001
10000000000001000000001100001111111111101
101111111011010000000000011101        101
1110000000000122222222110000111111    101
1110000000000100000002110000111111    101
1110000000000100000002110000111111    101
1111111111110100000002112000111111    101
10000000000000000000000000000000001   101
1110000000000N00000002110000111111    101
1110000000000100000002110000111111    101
1110000000000100000002110000111111    101
1110000000000122222222110000111111    101
10111111111101000000000001111         101
10000000000001000000001100001111111111101
10000000000001000000000000000000000000001
11111111111111111111111111111111111111111
