R 700 800



NO pics/Black5.xpm
SO pics/Black5.xpm
WE pics/Black5.xpm
EA pics/Black5.xpm

S pics/barrel.xpm
F 25,75,25 
C 0,80,150

111111111111111111111111111111
1001111111111111111111110000001
100102020202020020202010000001
100001202020202002000010000001
100E00000000000000000000000001
100001202020202002000010000001
100100202020202020202010000001
100111111111111111111110000001
111111111111111111111111111111
