R 750 550



NO pics/Black5.xpm
SO pics/Black5.xpm
WE pics/Black5.xpm
EA pics/Black5.xpm

S pics/barrel.xpm
F 25,75,25 
C 0,80,150

111111111111111111111111111111
100E00000000000000000000000001
100000000000000000000000000001
100000000000000000000000000001
100000000000000000000000000001
111111111111111111111111111111
